Postage stamp on/off – Alt + p
Disable or Enable – d
Info Viewer – i
Group – Ctrl + g
Copy Gizmo to group – Ctrl + Shift + g
Snap to Grid - |
Snap all to Grid - \
Connect – select one node then press Shift and click on another node and press y
Connect a Viewer node to a node – select the node and press 1

Disconnect node – select the node and press Ctrl + d
Disconnect a node from a tree – Ctrl + Shift + x
Select multiple nodes – press Shift while clicking each node you want to select
Select upstream nodes with a single click – press Ctrl + Shift and click a node from the node tree to select all upstream nodes from that node.
Select all nodes – Ctrl + a
Search node - /
Rename node – select a node and press n
Preferences – Shift + s
Preferences – Ctrl + ,
Project settings – s


Show curve editor – Shift + ~
Toggle full screen – Alt + s
Create New Viewer – Ctrl + i
Toggle hide float viewer - `
Next Tab – Ctrl + t
Close Tab – Shift + Esc
Clear Properties pane – put the cursor in Properties pane and Ctrl + Shift + a
If you want to add Tools Node in Foundry Nuke then

Read node – r
Write node – w
Copy node – k
Color Correct node – c
Grade node – g
Bazier node – p
Blur node - b
Merge node – m
Add Mix node – Shift + a
Transform node – t
Dot node - .
Sticky Note node – Alt + n
View related Foundry Nuke Shortcuts / Nuke Hotkeys

Pan – Alt + click and drag
Zoom out - - (minus sign)
Zoom in - + (plus sign)
Zoom in / out – Alt + click the middle mouse button and drag
Fit in view – f
Fill in Viewer pane only – h
View previous - ;
View next – ’